        ######## ##       ##     ## #### ########  #### ####        
        ##       ##       ##     ##  ##  ##     ## #### ####        
        ##       ##       ##     ##  ##  ##     ## #### ####        
        ######   ##       ##     ##  ##  ##     ##  ##   ##         
        ##       ##       ##     ##  ##  ##     ##                  
        ##       ##       ##     ##  ##  ##     ## #### ####        
        ##       ########  #######  #### ########  #### ####        


@@@@                                                            @@@@
@@@@@@@@@@@@                                            @@@@@@@@@@@@
@@@@@@@@@@@@@@@@@@@@@@@@@@@@@         @@@@@@@@@@@@@@@@@@@@@@@@@@@@@@
@@@@@@@@@@@@@@@@@@@@@@@@@@@@@@@@   @@@@@@@@@@@@@@@@@@@@@@@@@@@@@@@@@
                          @@           @@
                          @@           @@
                          @@           @@
                          @@@@@@@@@@@@@@@
                          @@@@@@@@@@@@@@@